_______________________________________________
__Z_B____EZ___V__N_B___Z___V__U___Z__B___EZ____
__XPPPPPPPXPPPPPPPPPPPPXPPPPPPPPPPXPPPPPPPX____
__L_______L____________L__________L_______L____
__L_______L____________LN__U___V__L__G___EL____
__L_G_ZE__L____________XPPPPPPPPPPXPPPPPPPX____
__XPPPXPPPX____________L__________L_______L____
__L___L___L____________L__________L_______L____
__L___L___L_N____Z_G___L__________LN_R____L____
__L___L___XPPPPPPXPPPPPX__________XPPPPPPPX____
__L___L___L______L_____L__________L_______L____
__LZR_L___L______L_____L__________L_______L____
__XPPPPPPPX______L_R___L_____V____L_______L____
__L_______L______XPPPPPXPPPPPPPPPPX_______L____
__L_______L______L_____L__________L_______L____
__L_______L______L_____L__________L_______L____
__L_______L______L_____L__________L_______L____
__L_B_____L__N___L_B___L__________LU_B____L____
__PPPPPPPPPPPPPPPPPPPPPP__________PPPPPPPPP____
_______________________________________________
_______________________________________________
_______________________________________________
_______________________________________________
___SSSSSS_________SSSSSS____________SSSSSS_____












