_______________________________________________
__ZEB_____ZV_N__Z__B___Z__V__B____Z___U__EZ____
__XPPPPPPPXPPPPPXPPPPPPXPPPPPPPPPPXPPPPPPPX____
__L_______L_____L______L__________L_______L____
__L_______L_____L______LN_U__G____L____Z_EL____
__L_G_Z___L_____L______XPPPPPPPPPPXPPPPXPPP____
__XPPPXPPPX_____L______L__________L____L_______
__L___L___L_____L______L__________L____L_______
__L___L___L_____L__G___L____ZR____L____L_______
__L___L___XPPPPPXPPPPPPXPPPPXPPPPPX____L_______
__L___L___L_____L______L____L_____L____L_______
__L___L___L_____L______L____L_____L____L_______
__L_R_L___L___V_L__R___L____L_____L____L_______
__XPPPPPPPXPPPPPPPPPPPPX____L_____L____L_______
__L_______L____________L____L_____L_N__L_Z__Z__
__L_______L____________L____L_____XPPPPPPXPPX__
__L_______L____________L____L_____L______L__L__
__L_B_____L_U______B___L_U__LB____L___V__L__L__
__PPPPPPPPPPPPPPPPPPPPPPPPPPPPPPPPPPPPPPPPPPP__
_______________________________________________
_______________________________________________
_______________________________________________
_______________________________________________
___SSSSSS_________SSSSSS____SSSSSS_____________
