_______________________________________________
_EZUB_____Z___EN__B____ZUB______NVZ___NZN_E____
_PXPPPPPPPXPPPPPXPPPPPPXPPPPPPPPPPXPPPPXPPP____
__L_______L____________L__________L____L_______
__L_______L____________LNG___E_U__L_N__L__E____
__L_G___ZNL____________XPPPPPPPPPPXPPPPPPPP____
__XPPPPPXPX____________L__________L____________
__L_____L_L____________L__________L____________
__L_____L_L__V_N_ZG____LUR___Z__E_L____________
__LU__V_L_PPPPPPPXPPPPPXPPPPPXPPPPP____________
__XPPPPPX________L_____L_____L_________________
__L_____L________L_____L_____L_________________
__L_R___L________LR____L_____L_________________
__XPPPPPX________XPPPPPX_____L_________________
__L_____LN___U___L_____L_____L_________________
__L_____XPPPPPPPPX_____L_____L_________________
__L_B___L________L_____L_____L_________________
__PPPPPPP________LB____LNB___L_________________
_________________PPPPPPPPPPPPP_________________
_______________________________________________
_______________________________________________
_______________________________________________
_______________________________________________
___SSSSSS________SSSSSS_SSSSSS_________________